{
  "width": 10,
  "height": 10,
  "mapTiles": [
    {"x": 0, "y": 0},
    {"x": 0, "y": 4},
    {"x": 0, "y": 5},
    {"x": 0, "y": 9},
    {"x": 1, "y": 1},
    {"x": 1, "y": 4},
    {"x": 1, "y": 5},
    {"x": 1, "y": 8},
    {"x": 2, "y": 2},
    {"x": 2, "y": 4},
    {"x": 2, "y": 5},
    {"x": 2, "y": 7},
    {"x": 3, "y": 3},
    {"x": 3, "y": 4},
    {"x": 3, "y": 5},
    {"x": 3, "y": 6},
    {"x": 4, "y": 0},
    {"x": 4, "y": 1},
    {"x": 4, "y": 2},
    {"x": 4, "y": 3},
    {"x": 4, "y": 6},
    {"x": 4, "y": 7},
    {"x": 4, "y": 8},
    {"x": 4, "y": 9},
    {"x": 5, "y": 0},
    {"x": 5, "y": 1},
    {"x": 5, "y": 2},
    {"x": 5, "y": 3},
    {"x": 5, "y": 6},
    {"x": 5, "y": 7},
    {"x": 5, "y": 8},
    {"x": 5, "y": 9},
    {"x": 6, "y": 3},
    {"x": 6, "y": 4},
    {"x": 6, "y": 5},
    {"x": 6, "y": 6},
    {"x": 7, "y": 2},
    {"x": 7, "y": 4},
    {"x": 7, "y": 5},
    {"x": 7, "y": 7},
    {"x": 8, "y": 1},
    {"x": 8, "y": 4},
    {"x": 8, "y": 5},
    {"x": 8, "y": 8},
    {"x": 9, "y": 0},
    {"x": 9, "y": 4},
    {"x": 9, "y": 5},
    {"x": 9, "y": 9}
  ]
}