{
  "width": 10,
  "height": 10,
  "mapTiles": [
    {"x": 0, "y": 0},
    {"x": 0, "y": 1},
    {"x": 0, "y": 4},
    {"x": 0, "y": 5},
    {"x": 0, "y": 8},
    {"x": 0, "y": 9},
    {"x": 1, "y": 0},
    {"x": 1, "y": 1},
    {"x": 1, "y": 4},
    {"x": 1, "y": 5},
    {"x": 1, "y": 8},
    {"x": 1, "y": 9},
    {"x": 2, "y": 2},
    {"x": 2, "y": 3},
    {"x": 2, "y": 6},
    {"x": 2, "y": 7},
    {"x": 3, "y": 2},
    {"x": 3, "y": 3},
    {"x": 3, "y": 6},
    {"x": 3, "y": 7},
    {"x": 4, "y": 0},
    {"x": 4, "y": 1},
    {"x": 4, "y": 4},
    {"x": 4, "y": 5},
    {"x": 4, "y": 8},
    {"x": 4, "y": 9},
    {"x": 5, "y": 0},
    {"x": 5, "y": 1},
    {"x": 5, "y": 4},
    {"x": 5, "y": 5},
    {"x": 5, "y": 8},
    {"x": 5, "y": 9},
    {"x": 6, "y": 2},
    {"x": 6, "y": 3},
    {"x": 6, "y": 6},
    {"x": 6, "y": 7},
    {"x": 7, "y": 2},
    {"x": 7, "y": 3},
    {"x": 7, "y": 6},
    {"x": 7, "y": 7},
    {"x": 8, "y": 0},
    {"x": 8, "y": 1},
    {"x": 8, "y": 4},
    {"x": 8, "y": 5},
    {"x": 8, "y": 8},
    {"x": 8, "y": 9},
    {"x": 9, "y": 0},
    {"x": 9, "y": 1},
    {"x": 9, "y": 4},
    {"x": 9, "y": 5},
    {"x": 9, "y": 8},
    {"x": 9, "y": 9}
  ]
}